11 11 11 11 11 11 11 11 11 11 11 11 11 11 11 11
11 11 11 11 11 11 11 11 11 11 11 135 11 11 11 11
11 11 11 19 16 16 16 16 16 16 16 16 16 16 16 16
11 11 19 16 16 24 40 16 24 40 16 16 16 16 16 16
11 19 16 16 16 25 41 16 25 41 16 16 16 16 16 16
11 16 16 16 16 16 16 16 16 16 16 16 16 16 16 16
11 18 16 16 16 16 24 40 16 24 40 16 16 16 16 16
11 11 18 16 16 16 25 41 16 25 41 16 16 16 16 16
11 11 11 18 16 16 16 16 16 16 16 16 16 16 16 16
11 11 11 11 11 11 11 11 11 11 11 11 11 11 11 11
11 11 11 11 11 11 11 11 11 11 11 11 11 11 11 11
RS:
15 05 01 00 F 7
//
DS:
//
IL:
//
ES:
//