59 59 59 59 16 61 61 59 59 59 59 59 59 59 59 59
59 59 135 67 16 61 61 51 59 59 59 59 59 59 59 59
59 67 16 16 16 61 61 16 16 16 16 16 16 16 16 16
59 16 16 16 16 61 61 16 56 16 16 16 56 16 16 16
59 16 16 16 16 61 61 16 16 16 56 16 16 16 16 16
59 16 16 56 16 61 61 16 56 16 16 16 56 16 16 16
59 16 16 16 16 61 61 16 16 16 56 16 16 16 16 16
59 16 16 16 16 61 61 16 56 16 16 16 56 16 16 16
59 66 16 16 16 61 61 16 16 16 16 16 16 16 16 16
59 59 58 58 66 61 61 50 58 58 58 58 58 58 58 58
59 59 59 59 59 61 61 59 59 59 59 59 59 59 59 59
RS:
15 05 06 00 F 7
04 10 05 01 T
//
DS:
//
IL:
//
ES:
//