59 59 59 59 59 59 59 59 59 59 59 59 16 16 59 59
59 59 59 59 59 59 59 135 59 59 59 67 16 16 59 59
16 16 16 16 16 16 16 16 16 16 16 16 16 16 59 59
16 16 16 16 16 16 16 16 56 16 16 16 16 16 51 59
16 16 16 16 16 16 16 16 16 16 56 16 16 16 16 51
16 16 56 16 16 56 16 16 56 16 16 16 16 16 16 16
16 16 16 16 16 16 16 16 16 16 56 16 16 16 16 50
16 16 16 16 16 16 16 16 56 16 16 16 16 16 50 59
16 16 16 16 16 16 16 16 16 16 16 16 16 16 59 59
58 58 58 58 58 58 58 58 58 58 58 58 58 58 59 59
59 59 59 59 59 59 59 59 59 59 59 59 59 59 59 59
RS:
15 05 07 00 F
13 10 06 01 T 2
//
DS:
//
IL:
//
ES:
//