59 59 59 59 59 59 59 16 16 59 59 59 59 59 59 59
59 59 59 59 135 59 67 16 16 59 59 59 59 59 59 59
59 59 59 67 16 16 16 16 16 59 59 59 59 59 59 59
59 59 67 16 16 16 16 16 16 59 59 59 59 59 59 59
59 67 16 16 16 16 16 16 16 51 59 59 59 59 59 59
16 16 16 16 16 16 16 16 16 16 16 16 16 16 16 16
58 66 16 16 16 16 16 16 16 16 16 16 16 16 58 58
59 59 16 16 16 16 16 16 16 16 16 16 16 16 59 59
59 59 16 16 16 16 16 16 16 16 16 16 16 16 59 59
59 59 58 58 58 58 58 58 58 58 58 58 58 58 59 59
59 59 59 59 59 59 59 59 59 59 59 59 59 59 59 59
RS:
15 05 08 00 F
08 10 07 01 T 2
//
DS:
04 10 07 00 I
//
IL:
//
ES:
//